#################################
#P..####..##...#..##...##..####.#
#...#.....#.#..#.#..#.#..#.#....#
#...###...#..#.#.#..#.#..#.###..#
#...#.....#...##.#..#.#..#.#....#
#...####..#....#..##...##..####o#
#################################
